afbarke	bark
affyre	fire
afskedige	fire
afslutte	close
aften	night
aks	ear
al	all
aldeles	all
alkohol	drink
alle	all
alt	all
alting	all
ask	ash
aske	ash
at	that
bagkrop	abdomen
bakke	hill
bark	bark
begrave	earth
ben	bone
betale	foot
bevoksning	stand
bid	bite
bide	bite
bjergart	rock
blad	leaf
blive	go
blod	blood
brand	fire
bryst	breast
bug	abdomen
bughule	abdomen
bytte	kill
Dem	you
denne	this
den	that
dette	this
det	that
De	you
dig	you
direkte	dead
disse	that
drab	kill
drikke	drink
drink	drink
dum	dull
du	you
dygtig	good
ej	not
elske	neck
en	you
estrade	stand
fed	fat
fedt	fat
fin	good
fiske	fish
fisk	fish
fjer	feather
fjern	distant
fjert	wind
flue	fly
fly	fly
flyve	fly
fod	foot
fortynde	thin
frisk	new
fritstille	fire
fryse	cold
fugl	bird
fuld	full
fuldtonet	full
fyldt	full
fyre	fire
gemme	hide
give	give
gode	good
god	good
godhed	good
godt	good
gold	dry
gribe	claw
gulne	yellow
gul	yellow
gylp	fly
hale	tail
hals	neck
havegang	path
hele	all
hjerte	heart
hjerter	heart
holdeplads	stand
holde	stand
horn	horn
hot	hot
hoved	head
hud	flesh
hud	hide
human	human
hund	dog
hunlig	female
hvad	what
hvem	who
hver	all
hvid	white
hvilken	what
hvilket	what
hvilke	what
ikke	not
ild	fire
ildsted	fire
I	you
jeg	I
jer	you
jordart	earth
jord	earth
jorde	earth
jordforbinde	earth
jordforbindelse	earth
kedelig	dull
kende	know
klare	stand
klo	claw
klosaks	claw
knogle	bone
kold	cold
komme	come
komplet	full
kort	short
kortslutning	short
kortslutte	short
kradse	claw
krop	flesh
krydre	salt
kulde	cold
kunne	know
kvinde	female
kvindelig	female
lang	long
lav	short
lever	liver
lidt	little
lige	dead
ligge	lie
lille	little
liste	nose
lukke	close
lyve	lie
mandlig	male
mange	many
mangen	many
man	you
mat	dull
menneske	human
menneskelig	human
mund	mouth
nat	night
navngive	name
navn	name
neger	black
ny	new
offer	kill
opfede	fat
opfede	flesh
opvarme	fire
orm	worm
os	smoke
overnatning	night
ovn	fire
passage	path
passe	go
plage	eat
prut	wind
regne	rain
regn	rain
regnvejr	rain
rejse	stand
retning	path
rive	claw
rock	rock
rod	root
rund	round
ryge	smoke
salte	salt
saltholdig	salt
salt	salt
sandfarvet	sand
sand	sand
sandstrand	sand
se	see
sidde	sit
sige	say
skind	hide
skjule	hide
skrubbe	bark
skumring	night
sky	cloud
slange	snake
sno	snake
sno	wind
snude	nose
snuse	nose
sol	sun
som	that
som	who
sort	black
sove	sleep
sparke	foot
spids	nose
spiritus	drink
spise	eat
stade	stand
stampe	full
standpunkt	stand
stand	stand
star	star
stift	see
stille	stand
sti	path
stjerne	star
stor	big
strand	sand
sund	good
tage	go
tand	tooth
tribune	stand
tud	nose
tunge	tongue
udholde	stand
udmunding	mouth
ugift	single
valke	full
vand	water
varm	hot
vej	path
vide	know
vid	full
vidneskranke	stand
vikle	wind
vind	wind
viser	hand
vi	we
