buk	abdomen
mage	abdomen
all	all
alle	all
alt	all
hele	all
ask	ash
bark	bark
bjeff	bark
voff	bark
stor	big
fugl	bird
rype	bird
bit	bite
bite	bite
biting	bite
bitt	bite
munnfull	bite
stikk	bite
tygge	bite
sort	black
svart	black
blod	blood
bein	bone
ben	bone
knokkel	bone
knulle	bone
pule	bone
bringe	breast
bryst	breast
bekk	burn
blad	burn
brenne	burn
brenning	burn
forbrenne	burn
forbrenning	burn
avslutte	close
lukke	close
stenge	close
fordunkle	cloud
overskye	cloud
sky	cloud
skye	cloud
kald	cold
kaldt	cold
kulde	cold
ankomme	come
kome	come
komme	come
bikkje	dog
hund	dog
drikke	drink
dum	dull
kjedelig	dull
matt	dull
aks	ear
jord	earth
ete	eat
spise	eat
egg	egg
feit	fat
fet	fat
korpulent	fat
tykk	fat
hunn	female
kvinne	female
avfyre	fire
avskjedige	fire
brann	fire
brenne	fire
fyr	fire
fyre	fire
sparke	fire
fisk	fish
fiske	fish
flue	fly
fly	fly
gylf	fly
toving	fly
tovinge	fly
betale	foot
fot	foot
labb	foot
pote	foot
sparke	foot
full	full
fullstendig	full
hel	full
komplett	full
mett	full
vid	full
gi	give
holde	give
overlate	give
overrekke	give
skjenke	give
date	go
dra	go
fare	go
forsvinne	go
ligge	go
bra	good
flink	good
god	good
gode	good
godt	good
mangelvare	good
snill	good
sunn	good
passe	go
reise	go
si	go
skulle	go
trekke	go
virke	go
gni	grind
kverne	grind
male	grind
raspe	grind
rive	grind
skrape	grind
gi	hand
hand	hand
handskrift	hand
overrekke	hand
side	hand
viser	hand
evne	head
hode	head
leder	head
nikke	head
rektor	head
sjef	head
skalle	head
skum	head
topp	head
hjarte	heart
hjerte	heart
hjerter	heart
hjertet	heart
dyrehud	hide
gjemme	hide
skinn	hide
skjule	hide
bakke	hill
brekke	hill
heit	hot
het	hot
hett	hot
lekker	hot
sexy	hot
sterk	hot
varm	hot
varmt	hot
menneske	human
menneskeaktig	human
menneskelig	human
jeg	I
drap	kill
drepe	kill
kne	knee
kjenne	know
kunne	know
vite	know
ark	leaf
blad	leaf
folie	leaf
leie	lie
ligge	lie
liggje	lie
ljuge	lie
lyve	lie
lite	little
liten	little
lever	liver
lang	long
lengte	long
hann	male
mannlig	male
mange	many
kjeft	mouth
munn	mouth
kalle	name
navn	name
navngi	name
nevne	name
ry	name
utnevne	name
velge	name
hals	neck
frisk	new
ny	new
aften	night
natt	night
overnatting	night
skumring	night
nese	nose
ei	not
ikke	not
sti	path
regn	rain
regne	rain
berg	rock
bergart	rock
crack	rock
edelstein	rock
gynge	rock
isbit	rock
kampestein	rock
kandissukker	rock
klippe	rock
riste	rock
rock	rock
ryste	rock
sjokkere	rock
stein	rock
rot	root
rund	round
bordsalt	salt
salt	salt
salte	salt
saltholdig	salt
sand	sand
sandfarget	sand
sandstrand	sand
strand	sand
si	say
kjerne	seed
se	see
kort	short
dromedar	single
enkel	single
enkelt	single
sitte	sit
ligge	sleep
sove	sleep
orm	snake
slange	snake
standa	stand
kjendis	star
stjerne	star
sol	sun
hale	tail
skygge	tail
at	that
hin	that
som	that
slank	thin
smal	thin
tynn	thin
denne	this
dette	this
disse	this
tunge	tongue
tann	tooth
tre	tree
tiss	water
vann	water
vanne	water
me	we
vi	we
hva	what
albe	white
hvem	who
som	who
fis	wind
fjert	wind
promp	wind
vind	wind
kravle	worm
krype	worm
makk	worm
mark	worm
orm	worm
gul	yellow
deg	you
din	you
du	you
dykk	you
