abdomen	abdomen
ventre	abdomen
par	all
totalement	all
tous	all
tout	all
toute	all
toutes	all
cendre	ash
aboi	bark
aboiement	bark
aboyer	bark
barque	bark
japper	bark
grand	big
gros	big
gonzesse	bird
minette	bird
nana	bird
oiseau	bird
oiselet	bird
oiselle	bird
poule	bird
taule	bird
mordre	bite
morsure	bite
piquer	bite
noir	black
Noir	black
Noire	black
ensanglanter	blood
sang	blood
baleine	bone
emmancher	bone
enculer	bone
fourrer	bone
os	bone
ossement	bone
blanc	breast
gorge	breast
hampe	breast
mamelle	breast
poitrail	breast
poitrine	breast
sein	breast
arder	burn
bruler	burn
brulure	burn
cramer	burn
flagrer	burn
graver	burn
griffe	claw
griffer	claw
pince	claw
boucher	close
clore	close
conclure	close
conclusion	close
fermer	close
fin	close
finir	close
intime	close
proche	close
terminer	close
nuage	cloud
froid	cold
froideur	cold
rhume	cold
arriver	come
devenir	come
entrer	come
jouir	come
primer	come
provenir	come
venir	come
milieu	dead
mort	dead
morts	dead
profondeur	dead
distant	distant
lointain	distant
chien	dog
Chien	dog
clameau	dog
thon	dog
boire	drink
boisson	drink
consommation	drink
verre	drink
aride	dry
essorer	dry
sec	dry
adoucir	dull
amortir	dull
assourdir	dull
barbant	dull
engourdir	dull
ennuyeux	dull
fastidieux	dull
idiot	dull
mat	dull
maussade	dull
morne	dull
obtus	dull
sot	dull
sourd	dull
stupide	dull
terne	dull
user	dull
balance	ear
indic	ear
labourer	ear
mouchard	ear
oreille	ear
enterrer	earth
sol	earth
terre	earth
terrier	earth
bouffer	eat
manger	eat
ronger	eat
ovule	egg
chas	eye
trou	eye
engraisser	fat
graisse	fat
gras	fat
gros	fat
lipide	fat
lipidique	fat
rond	fat
plume	feather
femelle	female
cuire	fire
feu	fire
foyer	fire
incendie	fire
licencier	fire
limoger	fire
partir	fire
renvoyer	fire
tir	fire
tirer	fire
virer	fire
poisson	fish
poissons	fish
carnation	flesh
chair	flesh
corps	flesh
peau	flesh
pulpe	flesh
battre	fly
braguette	fly
conduire	fly
lancer	fly
mouche	fly
papillon	fly
piloter	fly
voler	fly
patte	foot
payer	foot
pied	foot
ample	full
complet	full
entier	full
germain	full
plein	full
poissonneux	full
rassasier	full
repaitre	full
repu	full
total	full
bailler	give
donner	give
offrir	give
aller	go
allez	go
approbation	go
devenir	go
disparaitre	go
entrer	go
essai	go
faire	go
fonctionner	go
gagne	go
go	go
marcher	go
monter	go
bien	good
bon	good
bonne	good
bons	good
brave	good
fort	good
gentil	good
probe	good
sage	good
vaillant	good
partir	go
passer	go
remonter	go
tour	go
bleu	green
gazon	green
green	green
nouveau	green
verdir	green
vert	green
verte	green
broyer	grind
moudre	grind
capillaire	hair
chevelure	hair
cheveu	hair
cheveux	hair
poil	hair
poils	hair
aiguille	hand
donner	hand
main	hand
matelot	hand
passer	hand
aptitudes	head
avant	head
bout	head
calme	head
capitule	head
chapeauter	head
chef	head
chevet	head
commander	head
courir	head
directeur	head
directrice	head
diriger	head
dispositions	head
guider	head
mousse	head
sep	head
tinettes	head
entendre	hear
noyau	heart
sein	heart
suc	heart
cache	hide
cacher	hide
celer	hide
cuir	hide
dissimuler	hide
masquer	hide
peau	hide
planquer	hide
receler	hide
colline	hill
coteau	hill
avertisseur	horn
cor	horn
corne	horn
cuivres	horn
klaxon	horn
bonne	hot
chaud	hot
piquant	hot
radioactif	hot
sexy	hot
vif	hot
humain	human
humaine	human
je	I
assassinat	kill
assassiner	kill
cadavre	kill
homicide	kill
meurtre	kill
mort	kill
rectifier	kill
stopper	kill
trucider	kill
tuer	kill
victime	kill
genou	knee
connaitre	know
ignorer	know
savoir	know
battant	leaf
feuille	leaf
lame	leaf
ouvrant	leaf
rallonge	leaf
coucher	lie
mensonge	lie
mentir	lie
reposer	lie
trouver	lie
cadet	little
petit	little
peu	little
foie	liver
long	long
longtemps	long
longuement	long
temps	long
homme	male
masculin	male
beaucoup	many
maint	many
moult	many
nombreux	many
plusieurs	many
lune	moon
mois	moon
bouche	mouth
embouchure	mouth
goule	mouth
gueule	mouth
appeler	name
choisir	name
identifier	name
nom	name
nommer	name
col	neck
cou	neck
goulot	neck
manche	neck
nuque	neck
autre	new
neuf	new
nouveau	new
nouvel	new
nocturne	night
noirceur	night
nuit	night
soir	night
gueule	nose
museau	nose
nez	nose
odorat	nose
trompe	nose
ne	not
non	not
pas	not
peu	not
berme	path
chemin	path
route	path
sente	path
sentier	path
voie	path
pleuvoir	rain
pluie	rain
royer	rain
rose	red
rouge	red
roux	red
assurer	rock
balancer	rock
barguigner	rock
basculer	rock
bercer	rock
bouleverser	rock
brique	rock
caillou	rock
diam	rock
remuer	rock
roc	rock
roche	rock
rocher	rock
rock	rock
secouer	rock
secousse	rock
emmancher	root
enraciner	root
fourrer	root
origine	root
racine	root
radical	root
root	root
arrondi	round
arrondir	round
canon	round
cercle	round
complet	round
coup	round
ligne	round
reprise	round
rond	round
ronde	round
round	round
tour	round
saler	salt
salin	salt
sel	salt
cran	sand
plage	sand
sable	sand
sablonner	sand
dire	say
disons	say
indiquer	say
assister	see
comprendre	see
amandon	seed
apparier	seed
classer	seed
ensemencer	seed
graine	seed
semence	seed
semer	seed
sperme	seed
regarder	see
visiter	see
voir	see
bref	short
court	short
petit	short
commun	single
seul	single
simple	single
single	single
asseoir	sit
seoir	sit
chassie	sleep
coucher	sleep
dormir	sleep
sommeil	sleep
boucane	smoke
cigarette	smoke
clope	smoke
descendre	smoke
enfumer	smoke
fumer	smoke
gazer	smoke
furet	snake
serpent	snake
serpenter	snake
avis	stand
dresser	stand
halte	stand
kiosque	stand
opinion	stand
position	stand
pupitre	stand
socle	stand
soutenir	stand
stand	stand
supporter	stand
surgir	stand
sursauter	stand
astre	star
star	star
vedette	star
soleil	sun
Soleil	sun
nager	swim
natation	swim
pile	tail
queue	tail
aussi	that
ce	that
cela	that
celui	that
cet	that
cette	that
que	that
qui	that
si	that
tel	that
clair	thin
insuffisant	thin
maigre	thin
mince	thin
rare	thin
ce	this
ceci	this
cette	this
ardillon	tongue
langue	tongue
languette	tongue
dent	tooth
arborescence	tree
arboricole	tree
arbre	tree
abreuver	water
aquatique	water
aqueux	water
arroser	water
eau	water
eaux	water
irriguer	water
mouiller	water
saliver	water
urine	water
nous	we
on	we
comment	what
que	what
quel	what
quelle	what
quoi	what
blanc	white
blanche	white
lequel	who
qui	who
contourner	wind
enrouler	wind
essouffler	wind
gaz	wind
haleine	wind
pet	wind
pets	wind
remonter	wind
retourner	wind
souffler	wind
tordre	wind
tourner	wind
vent	wind
dragon	worm
faufiler	worm
infiltrer	worm
insinuer	worm
lombric	worm
ramper	worm
remords	worm
ver	worm
vermifuger	worm
vermine	worm
an	year
berge	year
froussard	yellow
jaune	yellow
jaunir	yellow
on	you
se	you
soi	you
toi	you
tu	you
vous	you
vousoyer	you
voussoyer	you
vouvoyer	you
