abdomen	abdomen
buk	abdomen
all	all
alla	all
alldeles	all
allt	all
hel	all
helt	all
ask	ash
aska	ash
bark	bark
barka	bark
hundskall	bark
skall	bark
kraftig	big
stor	big
storstad	big
vuxen	big
brud	bird
pulla	bird
bett	bite
bita	bite
bitande	bite
munsbit	bite
napp	bite
nappa	bite
stick	bite
tugga	bite
den	black
rapp	black
svart	black
svarta	black
blod	blood
blodprov	blood
blodsband	blood
ben	bone
benvit	bone
bringa	breast
brinna	burn
bryna	burn
klo	claw
riva	claw
avsluta	close
invid	close
slut	close
sluta	close
tillsluta	close
moln	cloud
sky	cloud
frusen	cold
kall	cold
kyla	cold
kylig	cold
snuva	cold
komma	come
borta	dead
hund	dog
hundras	dog
hynda	dog
alkohol	drink
dricka	drink
drickande	drink
drink	drink
dryck	drink
klunk	drink
spad	drink
sprit	drink
supa	drink
torka	dry
torr	dry
torrlagd	dry
vit	dry
dov	dull
matt	dull
oskarp	dull
ax	ear
majskolv	ear
ploga	ear
begrava	earth
jord	earth
jorda	earth
land	earth
lya	earth
mark	earth
mull	earth
gnaga	eat
spisa	eat
betrakta	eye
centrum	eye
glugg	eye
hyska	eye
vakta	eye
fet	fat
fett	fat
rik	fat
tjock	fat
hona	female
kvinnlig	female
avfyra	fire
avskeda	fire
beskjutning	fire
brand	fire
brasa	fire
eld	fire
focka	fire
fyr	fire
skjuta	fire
sparka	fire
spis	fire
ugn	fire
fisk	fish
fiska	fish
fiskar	fish
fiske	fish
fluga	fly
fly	fly
flyga	fly
gylf	fly
ben	foot
betala	foot
fot	foot
hov	foot
kicka	foot
sparka	foot
tass	foot
versfot	foot
full	full
ge	give
giva	give
lysa	give
bli	go
dejta	go
fara	go
fungera	go
go	go
heja	go
ljuda	go
bra	good
god	good
godhet	good
gott	good
nyttig	good
skicklig	good
stark	good
trivas	good
passa	go
promenera	go
resa	go
tur	go
oerfaren	green
gnida	grind
mala	grind
bunt	hand
flank	hand
ge	hand
hand	hand
handlag	hand
handstil	hand
handtag	hand
klase	hand
ledsaga	hand
namnteckning	hand
sida	hand
skicklighet	hand
underskrift	hand
visare	hand
bornyr	head
chef	head
fattning	head
fradga	head
huvud	head
knopp	head
leda	head
ledare	head
huvudlus	head louse
mot	head
nicka	head
rektor	head
skalla	head
skalle	head
skum	head
spets	head
topp	head
hud	hide
skinn	hide
backe	hill
kulle	hill
horn	horn
tuta	horn
febrig	hot
het	hot
kryddstark	hot
stark	hot
stulen	hot
tuff	hot
varm	hot
jag	I
uppfattning	I
assasinera	kill
avliva	kill
riva	kill
kunna	know
veta	know
blad	leaf
klaff	leaf
skiva	leaf
ligga	lie
ljuga	lie
lura	lie
vals	lie
lite	little
liten	little
litet	little
yngre	little
lever	liver
handjur	male
hane	male
hankontakt	male
hanne	male
man	male
manlig	male
moona	moon
flodmynning	mouth
mun	mouth
mynning	mouth
heta	name
namn	name
namna	name
namnge	name
utse	name
hals	neck
nacka	neck
ny	new
natt	night
skymning	night
nos	nose
nosa	nose
smyga	nose
snoka	nose
spets	nose
ej	not
icke	not
ingalunda	not
inte	not
bana	path
cykelbana	path
kurs	path
stig	path
regn	rain
regna	rain
berg	rock
bergart	rock
chocka	rock
crack	rock
diamant	rock
gunga	rock
gungning	rock
isbit	rock
klippa	rock
klippblock	rock
kobbe	rock
polkagris	rock
rock	rock
rocka	rock
skaka	rock
spela	rock
sten	rock
stenblock	rock
vagga	rock
vaggande	rock
vyssja	rock
vyssjande	rock
heja	root
ordrot	root
rot	root
rota	root
tandrot	root
allsidig	round
avrunda	round
avrundad	round
golfrunda	round
kanon	round
lov	round
moment	round
patron	round
rond	round
rund	round
runda	round
rundad	round
tur	round
varv	round
bordssalt	salt
koksalt	salt
krydda	salt
salt	salt
salta	salt
salthaltig	salt
sand	sand
sanda	sand
sandpappra	sand
sandstrand	sand
slipa	sand
strand	sand
ponera	say
seeda	seed
seedning	seed
sperma	seed
se	see
stift	see
stiftstad	see
uppfattning	see
varsebli	see
blanka	short
kort	short
kortsluta	short
kortslutning	short
kortvarig	short
enda	single
enhetlig	single
enkel	single
enskild	single
enstaka	single
odelad	single
ogift	single
singel	single
ligga	sit
ruva	sit
sitta	sit
godmorgon	sleep
gomorron	sleep
morgongrus	sleep
sova	sleep
sovande	sleep
tupplur	sleep
cigg	smoke
ryka	smoke
orm	snake
slingra	snake
snok	snake
vindla	snake
kandidera	stand
position	stand
stativ	stand
tolerera	stand
asterisk	star
sol	sun
sola	sun
solljus	sun
simma	swim
simtur	swim
klave	tail
rumpa	tail
svans	tail
att	that
den	that
denna	that
dessa	that
det	that
detta	that
som	that
uppfatta	that
vilken	that
klen	thin
mager	thin
smal	thin
tunn	thin
den	this
denna	this
detta	this
tunga	tongue
hjultand	tooth
kugg	tooth
kugge	tooth
tand	tooth
skoblock	tree
vatten	water
vattenbrist	water
vattenyta	water
vattna	water
man	we
vi	we
som	what
va	what
vad	what
vilken	what
ljushyad	white
ljushyllt	white
vit	white
vita	white
vitt	white
som	who
vem	who
vilka	who
fis	wind
linda	wind
spola	wind
vind	wind
vinda	wind
vittra	wind
mask	worm
stackare	worm
feg	yellow
gul	yellow
gulna	yellow
dig	you
din	you
ditt	you
du	you
Du	you
en	you
er	you
era	you
man	you
ni	you
Ni	you
nia	you
